111111111111111
100P01000000001
100001000100001
1011110001C0001
100010000111101
1C00100C0100001
1110000111E0C11
111111111111111

