111111111111
100000P11111
1000000000E1
100000000001
111111111111
