1111111111111111111111111111111111111111
1000000000000000000000000000000000000001
100000011111100000000000001111110000C001
1000001000001000000000000100000010000001
1000010000001000000000001000000001000001
1000100000001000000C00000000000000100001
1P01000000001000000000000000000000100001
1010000000001000000000000000000001000001
1111111111111111111100000000000110000001
1000000000001000000000000000011000000001
1000000000001000000000000001100000000001
1000000C00001000000C00000110000000000001
1000000000001000000000011111111111111001
10000000000000000000000000000000000000E1
1111111111111111111111111111111111111111
