1111111111
100P000001
1000000001
1000000001
1111111111
