1111111111111111111111
10000P01000000001100E1
1010000100010000000011
101011110001C000111011
1010001000011110100001
101C00100C011111100001
10001000011110C00000C1
1111111111111111111111
