111111111111
100000000E1
100P000001
100000C01
10000001
1111111