111111111111111111111111111111
00C000000000000000000000000001
10000000000000P0000000C0000001
100000000000000000000000000001
100000000000000C10000000000001
100000000000000010000000000E01
100000C00000000010000000000001
111111111111111111111111101111