111111111111111111111111111
100000000000000000000000001
100000000011111111111000001
10000000001         1000001
10000000P01         100C0E1
11111111111         1111111