1111111111111111111111
10100P01000000001100C1
1010000100010000100011
101011110001C000100001
1010001000011110111001
101C00100C010000100001
10111000011110C0E00011
1111111111111111111111