11111111111111111111
100P01000000001100E1
10000100000000000011
1000000001C000100001
11101100011000100001
1C00100C010000100001
100000000000C00000C1
11111111111111111111