1111111111111111111111
1C100P01000000001100C1
1010000100010000100011
101011110001C000100001
10100010000111101E1111
100C00100C010000100001
10111000011110C00000C1
1111111111111111111111