111111111111111111111111111111
10C000000000000000000000000001
10000000000000P0000000C0000001
100000000000000000000000000001
100000000000000C00000000000000
100000000000000000000000000E00
100000C00000000000000000000000
111111111111111111111111111110