111111111111111111111111111111
10C000000000000000000000000001
1000000000000000000000C0000001
100000000000000000000000000001
100P00000000000C00000000000001
100000000000000000000000000001
100000C00000000000000000000001
111111111111111111111111111111