111111111111111111111111111111
10C000000000000000000000000001
10000000000000P0000000C0000001
100000000000000000000000000001
111111000000000000000000000001
100001110000000000000000000E01
100C01C10000000000000000000001
111111111111111111111111111111