111111111111111111111111111111
10P001000000000000000000000001
1000010000000000000000C0000001
111111000000000000000000000001
100000000000000C00000000000001
100000000000000000000000000E01
100000C00000000000000000000001
111111111111111111111111111111