1111111111111111111111
1C100P01000000001100E1
1010000100010000000011
101011110001C000100001
1010001000011110100001
100C00100C010000100001
10111000011110C00000C1
1111111111111111111111