111111111111111111111111111111
10 000000000000000000000000001
10000000000000P000000000000001
100000000000000000000000000001
100000000000000000000000000001
100000000000000000000000000E01
100000000000000000000000000001
111111111111111111111111111111