111111111111111111111111111111
10C000000000000001000000000001
10000000000000P0010000C0000001
100000000000000001000000000001
100000000000000C00001111111111
100000000000000000008000000E01
100000C00000000000000000000001
111111111111111111111111111111