11111111111111111111111111111
10100010000P00000010101111111
10101010111111101010101111111
101010100000C0101010100111111
10101011111111101010101111111
10101010000000101000101111111
10101010111110101111101111111
101010100000101010001C0011111
10111011101010101010101011111
10000010001010101010101011111
11101111111010101110101000001
10000010000010100010101111101
11111010111110111010001111001
10001000001000001010100011001
10101111101110101010111000001
101000000010001000001000111E1
11111111111111111111111111111