1111111111111111111111111111111
1000010000C00000000000000000001
1011110011111111111110111000101
101000001000000000001010CE00101
100C110010001100000010101110101
1000010000101000000010111000101
1001110111100000P00010001111101
1001000000101000000010000111C01
1001000010101C11111110010001101
1011C11010101110000011110101101
1000000010100000010000000100001
1111111111111111111111111111111