1111111111111111111111111111111111111111
1000P10000100010000100000100010000100001
1000010000101010C0010100010C010000100001
1000010000101010000101000100010000100001
101100010000100000000100000111E000000001
100101011111111111111100000001C111111001
1001011100000000000001000000011100000001
1C01000001111000001100011111110000111111
111111111111111111110C000000000000001111
1111111111111111111111111111111111111111