11111111111111111111111
10100010000P00000010101
10101010111111101010101
101010100000C0101010101
10101011111111101010101
10101010000000101000101
10101010111110101111101
101010100000101010001C1
10111011101010101010101
10000010001010101010101
11101111111010101110101
10000010000010100010101
11111010111110111010001
10001000001000001010101
10101111101110101010101
10100000101000100010101
10111110101011101110101
10100010101000101000101
10101010111110101010101
10001010000E00100010101
11111111111111111111111


